12	dwanijst	Mc---d
2+2=5	2+2=5	X
32	trïstinudwa	Mc---d
5	pet	Mc---d
Bila	bet	Vaps-sfa------p
Bode	bet	Vasp3s--------p
Bohavei	böguw	Aopfsl
Bohon	bug	Ncmsi
Bohouv	böguw	Aopmsan-n
Bohovaha	böguw	Aopmsg
Bohove	böguw	Aopmpa
Bohovih	böguw	Aopmpg
Bohovih	böguw	Aopmpl
Bohovij	böguw	Aopfsl
Bohovin	böguw	Aopmsl
Bohuvin	böguw	Aopmsl
Bohù	bug	Ncmsd
Boshij	böžji	Aopmsny
Calvarj	kalvarij	Npm
Chiri	kiri	Pq-mpn----n
Chrishtianschin	krištijanski	Afpnsl
Christusa	krïštuš	Npmsa--y
Christusam	krïštuš	Npmsi
Ciete	tët	Voip2p--n-----py
Coj	koj	Pq---a----n
Comandatmiteh	komandament	Ncmpl
Crishtusha	krïštuš	Npmsa--y
Crishtusha	krïštuš	Npmsg
Dapiton	dapit	Npmsi
Dolorano	dolorän	Afpfsa
Dolorozna	dolorozan	Afpfsn
Du	du	Pq---n----n
Dáite	dät	Vmmp2p--------ey
Elisabeto	elizabeta	Npfsa
Emaus	emaus	Npmsn
Erove	jëruw	Aopnsny
Eve	eva	Npfsg
Giesù	ǵežu	Npm
Giò	ǵö	I
Isa	isi	Pd-fsn----n
Iso	isi	Pd-nsn----n
Itè	iti	Pd-npa----a
Jeruzalem	jeruzalem	Npmsa--n
Jeruzalima	jeruzalem	Npmsg
Jeruzalimu	jeruzalem	Npmsl
Jesus	jëžuš	Npmsn
Jesusa	jëžuš	Npmsg
Jesusoua	jëžušuw	Aopfsn
Jezuša	jëžuš	Npmsa--y
Ježušova	jëžušuw	Aopmdn
Jurinawa	jürinuw	Aopfsn
Kaki	kak	Pq-mpn----n
Kalvarii	kalvarij	Npm
Kalvariu	kalvarih	Npmsd
Kalvorih	kalvarih	Npmsa--n
Kristušon	krïštuš	Npmsi
Kristušu	krïštuš	Npmsd
Kíra	kiri	Pq-fsn----a
Kíri	kiri	Pq-msn----n
Ma	möj	Ps1fsns---a
Maria	marïja	Npfsn
Marie	marïja	Npfsg
Marija	marïja	Npfsn
Mario	marïja	Npfsa
Marà	marat	Voip3s--n-----p
Misteriha	mišterih	Ncmdn
Na	un	Pp3fsn--y-n
Naszy	näš	Ps1mpdp---a
Nazarenskaha	nazarenski	Aopmsg
Neba	nëbë	Ncnsg
Nebba	nëbë	Ncnsg
Nebbe	nëbë	Ncnsl
Ni	bet	Vmip3s--y-----p
Ni	un	Pp3mpn--y-n
Njì	nji	Ps3---sf--a
Ogia	oćä	Ncmsn
Oh	ö	I
Onà	un	Pp3fsn--n-n
Oshtie	oštja	Ncfsg
Ostani	ostät	Vmmp2s--------e
Paravishe	paravïž	Ncmsl
Parnisijta	parnistet	Vmmp2p--------en
Persun	parsuna	Ncfpg
Persunami	parsuna	Ncfpi
Pinsajmo	pinsät	Vmmp1p--------e
Prydy	prït	Vmsp3s--------e
Qutri	kwatri	Ncm
R	r	Y
Ravanci	ravanca	Npfsl
Rezije	rezija	Npfsg
Rezije	rezija	Npfsl
Reziji	rezija	Npfsl
Ricite	rićet	Vmmp2p--------py
Rim	rim	Npmsa--n
Rime	rim	Npmsl
Romanchi	romanjski	Afpfsd
Rozajanski	rozajanski	Afpmsny
Sacraminteh	srament	Ncmpl
Santissima	šantišim	Afsfsn
Santiſshima	šantišim	Afsfsn
Santiſsim	šantišim	Afs
Santiſsima	šantišim	Afsfsn
Se	isi	Pd-msn----n
Sedan	sëdan	Mc-p-l
Simeunu	šimeun	Npmsd
Spovedat	spovëdat	Vmn-----------e
Sveta	svet	Afpfsn
Svetaha	svet	Afpmsg
Svete	svet	Afpfsg
Svete	svet	Afpnsny
Sveti	svet	Afpfpa
Sveti	svet	Afpfsd
Svetih	svet	Afpmpl
Svetih	sveti	Afpmpg
Sveto	svet	Afpfsa
Sè	isi	Pd-fpn----a
Ta	te	Tffsn
Tastá	tet	Vmmp2p--------pn
Te	te	Tffpn
Te	te	Tfmsn
Ti	iti	Pd-mpn----n
Ti	te	Tfmpn
Tuw	tuw	Spcl
Tè	te	Tfmdn
Uas	väs	Pg-msn----an
Un	un	Pp3msn--n-n
Usamite	wzet	Vmmp2p--------en
Use	väs	Pg-nsn----n
Usi	väs	Pg-mpn----n
Uvsè	väs	Pg-nsa----a-n
Verij	vërwat	Vmmp2s--------p
Vi	vï	Pp2-pn--n-n
Villichj	vilek	Afpfsl
Vsem	väs	Pg-mpd----a
Vïdnë	vïdan	Npmsl
Za	za	Sps
Zuite	čot	Vmmp2p--------pn
a	un	Pp3msn--y-n
accompagnaimu	akompanjät	Vmmp1p--------e
amai	amät	Vmsp1s--------e
amai	amät	Vmsp1s--------p
amaite	amät	Vmmp2p--------pn
aman	amät	Vmip1s--n-----e
an	un	Pp3msn--y-n
ano	anu	Ccs
anu	anu	Ccs
banaden	binidet	Vmp--sfp------e
becew	beč	Ncmpg
benedila	binidet	Vmps-sfa------e
bese	bet	Vaii3s--------p
bese	bet	Vcii3s--------p
besideh	bisida	Ncfpl
bet	bet	Vcn-----------p
beše	bet	Vaii3s--------p
bil	bet	Vaps-sma------p
bil	bet	Vcps-sma------p
bila	bet	Vaps-sfa------p
bila	bet	Vcps-sfa------p
bile	bet	Vaps-pfa------p
bile	bet	Vcps-pfa------p
bili	bet	Vaps-pma------p
bili	bet	Vcps-pma------p
bilo	bet	Vaps-sna------p
bilo	bet	Vcps-sna------p
bilu	bet	Vcps-sna------p
bit	bet	Van-----------p
bit	bet	Vcn-----------p
bit	bet	Vmp--smp------p
biti	bet	Van-----------p
biti	bet	Vcn-----------p
biu	bet	Vcps-sma------p
blishgnaha	blïžnji	Afpmsa--y
blíshghnili	blïžnjit	Vmps-pma------p
bo	bet	Vaif3s--------p
bo	bet	Vmif3s--------p
bo	bö	Rgc
bodete	bet	Vasp2p--------py
bodi	bet	Vasp3s--------p
bodi	bet	Vcsp3s--------p
bodite	bet	Vasp2p--------py
bodê	bet	Vcsp3s--------p
bogan	bogat	Vmip1s--------p
bohala	bogat	Vmps-sfa------p
boijo	bat	Vmip3p--n-----p
bom	bet	Vaif1s--------p
bon	bet	Vaif1s--------p
bota	bet	Vaif2p--n-----pn
božjega	böžji	Aopmsa--y
bramase	bramät	Vmii3s--------e
bramase	bramät	Vmii3s--------p
bujše	bujši	Afcnsn
byl	bet	Vaps-sma------p
bè	bet	Vaia3s--------p
bé	bet	Vcia3s--------p
bého	bet	Vcii3p--------p
bögavi	böguw	Aopmpg
bě	bet	Vaia3s--------p
běše	bet	Vcii3s--------p
cach	kak	Pi-msa----a
cert	čert	Afp
chira	kiri	Pi-fsn----n
chira	kiri	Pq-fsn----n
chire	kiri	Pq-fpn----n
chirj	kiri	Pq-fsl----a
chrivaha	krïw	Afpnsg
ch’	ka	Pr--------n
cion	tët	Voip1s--n-----p
clizala	klïcat	Vmps-sfa------p
coga	du	Pq---a----n
colina	kolënu	Ncnpa
comsumano	konsumät	Vmp--snp------e
contemplaimo	kontemplät	Vmmp1p--------e
coronana	koronät	Vmp--smp------e
coronana	koronät	Vmp--smp------p
costi	kust	Ncfpn
crisan	krïžat	Vmp--smp------p
dalesgni	dalëčnji	Afpmsa--n
damuw	damu	Rgp
dan	dan	Timsa-n
dan	dan	Timsn
dan	dän	Mcmsnl
dan	dän	Pi-msn----n
dardu	dardu	Sps
daržaho	däržat	Vmii3p--------p
datte	dät	Vmip2p--n-----py
delala	dëlat	Vmps-sfa------p
delalo	dëlat	Vmps-sna------p
delavec	dëlavac	Ncmsn
delečni	dalëčnji	Afpmsny
delo	dëlu	Ncnsn
den	dan	Timsa-n
dialëte	dijalët	Ncmpa
dikla	dikla	Ncfsn
dikle	dikla	Ncfpa
dilaiog	dëlat	Vmp----a------p
dileh	dëlu	Ncnpl
din	din	X
discépula	dišepul	Ncmdn
dna	dän	Mcfsnl
dnaha	dan	Timsa-y
dneha	dan	Tinsg
dnej	dän	Mcfsdl
dnej	dän	Mcfsll
dni	dan	Timpn
dnin	dan	Timsl
dnohà	dän	Mcmsal---y
dnumu	dän	Pi-msd----n
dní	din	Ncmpg
dnó	dän	Mcfsal
dobar	dobar	Afpmsan-n
dobre	dobar	Afpfpn
dobre	dobar	Afpnsay-n
dobrim	dobar	Afpmpd
dobrute	dubruta	Ncfpa
dolu	dölu	Rgp
dorivale	durivät	Vmps-pfa------e
dret	drët	Q
druhe	drügi	Afpfpa
druhemu	drügi	Afpmsd
druhomu	drügi	Afpmsd
drüge	drügi	Afpfpa
dua	dwa	Mcmdal
dua	dwa	Mcmdnl
dulsnichen	dužnïk	Ncmpd
dušici	dušïca	Ncfsd
dužnikaên	dužnïk	Ncmpd
dvi	dwa	Mcfdal
dílan	dëlat	Vmip1s--------p
dúlg’he	dulg	Ncmpa
era	jëru	Ncmsa--y
etej	iti	Pd-msa----a-n
fameja	fameja	Ncfsn
fameje	fameja	Ncfsd
faméja	famëj	Ncmsa--y
fiesto	fjëšta	Ncfsa
furlanske	furlanski	Afpfpn
furlanskë	furlanski	Afpnsan-n
g_nagn	un	Pp3msg--n-n
ga	un	Pp3msa--y-n-y
ga	un	Pp3nsa--y-n-y
gardimi	gärd	Afpmpi
gauo	tet	Vmmp1p--------p
gauò	tet	Vmmp1p--------p
ghian	ǵat	Vmp--smp------e
giò	tët	Vaip1s--n-----p
gnagá	un	Pp3msa--n-n-y
gne	un	Pp3-pa--b-n
gnega	un	Pp3msa--b-n-y
gnega	un	Pp3msa--n-n-y
gnemu	un	Pp3msl--n-n
gni	nji	Ps3---sf--a
gniei	un	Pp3fsd--n-n
gniei	un	Pp3fsl--n-n
gnih	njeh	Ps3---p---a
gnimi	un	Pp3-pi--n-n
gnimu	un	Pp3msd--n-n
gnín	un	Pp3-pd--n-n
gorelo	gorët	Vmps-sna------p
grisniki	grišnik	Ncmpn
h	h	Spsd
ha	un	Pp3msa--y-n-y
ha	un	Pp3msg--y-n
hardéhata	tet	Vmii3d--------p
hardéše	tet	Vmii3s--------p
herdého	tet	Vmii3p--------p
hisa	hïša	Ncfsg
hisi	hïša	Ncfsd
hovarnajte	govarnät	Vmmp2p--------ey
hovarnajte	govarnät	Vmmp2p--------py
hrazij	gračja	Ncfsl
hrishi	grišit	Vmmp2s--------e
hriſsi	grih	Ncmpi
hrodu	hrod	Ncmsd
hudaha	hüd	Afpnsg
húdega	hüd	Afpnsg
i	i	X
idu	tet	Vmia3s--n-----p
ih	un	Pp3-pa--y-n
im	un	Pp3-pd--y-n
ime	jïmë	Ncnsn
imenom	jïmë	Ncnsi
imme	jïmë	Ncnsn
in	un	Pp3-pd--y-n
inimigen	inimïg	Ncmpd
intendate	intendät	Vmip2p--n-----en
intendate	intendät	Vmip2p--n-----pn
io	un	Pp3fsa--y-n
isa	isi	Pd-fsn----a
ise	isi	Pd-fpn----a
ise	isi	Pd-msn----a
ishtes	ištës	Pg--------a
isi	isi	Pd-msn----a
iso	isi	Pd-fsa----a
iso	isi	Pd-nsn----n
istriki	štrïk	Ncmpi
isà	isi	Pd-fsn----a
isè	isi	Pd-mpa----a
isè	isi	Pd-msn----a
isó	isi	Pd-fsa----a
isó	isi	Pd-nsa----a-n
isó	isi	Pd-nsa----n-n
ite	iti	Pd-mpa----n
ite	iti	Pd-msa----a-n
ite	iti	Pd-msa----n-n
iti	iti	Pd-msa----n-n
iti	iti	Pd-msn----n
itim	iti	Pd-msl----a
itin	iti	Pd-msl----a
ito	iti	Pd-fsa----a
ito	iti	Pd-nsa----n-n
itoga	iti	Pd-msg----a
itoga	te	Tfmsg
itoha	iti	Pd-nsg----n
itu	ito	Rgp
itën	iti	Pd-mpd----n
ió	un	Pp3fsa--y-n
ja	jä	Pp1-sn--n-n
ja	jä	Pp1-sn--y-n
jajcè	jajcë	Ncnsa--n
je	bet	Vaip3s--n-----p
je	bet	Vcip3s--n-----p
je	un	Pp3-pa--y-n
je	un	Pp3fsg--y-n
je	un	Pp3msa--y-n-n
jesus	jëžuš	Npmsn
ji	un	Pp3fsd--y-n
jima	un	Pp3-dd--y-n
jo	un	Pp3fsa--y-n
judmi	jüdi	Ncmpi
j́i	un	Pp3-pg--y-n
j́i	un	Pp3msa--y-n-n
k	ka	Css
kako	kak	Pi-nsa----ann
ke	ka	Pr--------n
kej	kej	Pi---a----n
kir	kir	Css
kir	kir	Pr--------n
kiri	kiri	Pi-msn----a
kitinami	këtina	Ncfpi
kliče	klïcat	Vmip3s--n-----p
klíce	klïcat	Vmip3s--n-----p
ko	koj	Pq---a----n
koj	koj	Pq---n----n
koja	koji	Pr-fsn----a
kontent	kontent	Afp
kričofižon	kričofïž	Ncmsi
kruck	kroh	Ncmsa--n
kunvirtínaga	kunvirten	Afpmsa--y
k’	ka	Css
lashi	lägat	Vmmp2s--------p
legri	legro	Afpmpn
lit	lëtu	Ncnpg
lita	lëtu	Ncnpa
lípce	lip	Afcnsa--n
lít	lëtu	Ncnpg
löpu	lip	Afpnsnn
ma	bet	Vcip3s--n-----p
ma	jä	Pp1-sa--y-n
ma	möj	Ps1fsns---a
mabej	mabej	Csc
malu	mäl	Afpnsan-n
mamö	mët	Voip1p--n-----p
man	mët	Vcip1s--n-----p
martve	märtuw	Afpmpa
mata	mët	Vcip2p--n-----pn
mata	mët	Vmip2d--n-----p
me	jä	Pp1-sa--b-n
me	jä	Pp1-sa--y-n
me	möj	Ps1fsgs---a
mej	möj	Ps1fsds---a
mel	mët	Vcps-sma------p
mela	mët	Vops-sfa------p
mele	mët	Vcps-pfa------p
mele	mët	Vops-pfa------p
memi	möj	Ps1mpis---a
meritat	maratät	Vmn-----------p
merzlo	zmärzal	Afpfsi
mese	mët	Vcii3s--------p
mestagh	mëstu	Ncnpl
mi	jä	Pp1-sd--y-n
mi	mï	Pp1-pn--n-n
mi	mï	Pp1-pn--y-n
miga	möj	Ps1msgs---a
miha	möj	Ps1msas---a-y
mimu	möj	Ps1msds---a
mislen	mïslit	Vmip1s--n-----p
mison	misu	Ncnsi
mlaisi	mlad	Afcmsn
mle	jä	Pp1-sg--n-n
mlu	jä	Pp1-si--n-n
mlè	jä	Pp1-sa--n-n
mlé	jä	Pp1-sd--n-n
mlé	jä	Pp1-sl--n-n
mo	möj	Ps1fsas---a
mo	möj	Ps1nsas---a-n
mo	möj	Ps1nsns---a
mogal	morët	Vops-sma------p
moi	muj	Ps1mpns---a
moi	möj	Ps1msns---a
moj	möj	Ps1msns---a
morata	bet	Voip2p--n-----pn
more	morët	Voip3s--n-----p
morem	morët	Voip1s--n-----p
moren	morët	Voip1s--n-----p
mores	morët	Voip2s--n-----p
moret	morët	Von-----------p
morete	morët	Voip2p--n-----pn
moćan	möćan	Afpmsnn
mu	un	Pp3msd--y-n
mugle	morët	Vops-pma------p
muij	möj	Ps1mpns---a
munije	münija	Ncfpn
murgniulou	murnjulät	Vmps-sma------p
my	mï	Pp1-pn--n-n
mysom	misu	Ncnsi
méla	mët	Vcps-sfa------p
méše	mët	Voii3s--------p
mële	mët	Vmps-dfa------p
mó	möj	Ps1nsns---n
na	dan	Tifsn
na	dan	Timpa
na	na	Spsa
na	na	Spsl
na	na	Spsn
na	un	Pp3fsn--y-n
na	un	Pp3mdn--y-n
nadejo	nadëja	Ncfsa
nadivahamo	nadivat	Vmii1p--------p
naga	dan	Timsg
nagha	dan	Timsa-y
naha	dan	Timsg
najlipsi	lip	Afsmsa--n
naju	mïdwa	Pp1-da--n-n
naju	mïdwa	Pp1-dl--n-n
naju	naju	Ps1---d---a
nalese	nalëst	Vmia3s--n-----e
nalíse	nalëst	Vmip3s--n-----e
nam	mï	Pp1-pd--n-n
nama	mïdwa	Pp1-dd--n-n
nami	mï	Pp1-pi--n-n
nan	mï	Pp1-pd--n-n
nan	mï	Pp1-pd--y-n
nas	mï	Pp1-pa--b-n
nas	mï	Pp1-pa--n-n
nas	mï	Pp1-pa--y-n
nash	näš	Ps1msap---a-n
nash	näš	Ps1msnp---a
nasha	näš	Ps1fsnp---a
nashaha	näš	Ps1msap---a-y
nashaha	näš	Ps1msgp---a
nashanà	nistet	Vmp--sfp------p
nashe	näš	Ps1fsgp---a
nashe	näš	Ps1mpap---a
nashin	näš	Ps1mpdp---a
nasho	näš	Ps1fsap---a
nasi	näš	Ps1mpnp---a
nasih	näš	Ps1mpgp---a
nass	mï	Pp1-pa--y-n
nassega	näš	Ps1msgp---a
nasz	näš	Ps1msap---a-n
nasz	näš	Ps1msnp---a
naszaha	näš	Ps1msap---a-y
nasze	näš	Ps1mpap---a
naszey	näš	Ps1fsgp---a
nas’h	näš	Ps1msnp---a
naêm	mï	Pp1-pd--n-n
naši	näš	Ps1mpnp---a
naših	näš	Ps1mpgp---n
ne	dan	Tinpa
ne	un	Pp3fpn--y-n
nebe	nëbë	Ncnsl
nebeška	nabëški	Aopfsn
nebu	nëbë	Ncnsd
nej_već	najveć	Rgs
nejveć	najveć	Rgs
nenke	nenki	Pg-fpn----a
ni	bet	Vaip3s--y-----p
ni	bet	Vcip3s--y-----p
ni	bet	Vmip3s--y-----p
ni	dan	Tifsd
ni	dan	Tifsl
ni	ni	Q
ni	un	Pp3fpn--y-n
ni	un	Pp3mpn--y-n
ni_kógor	nišći	Pz---g----n
ni_so	bet	Vaip3p--y-----p
nicar	nikar	Pz---a----n
nikar	nikar	Pz---a----n
nikar	nikar	Pz---n----n
nimaio	mët	Vcip3p--y-----p
nimajo	mët	Voip3p--y-----p
nimate	mët	Vmip2p--y-----py
ninega	nidan	Pz-msg----n
ninega	nidan	Pz-nsg----a
nisgi	nišći	Pz---n----n
nisi	bet	Vaip2s--y-----p
nisi	bet	Vcip1s--y-----p
niso	bet	Vaip3p--y-----p
nisçhí	nišći	Pz---n----n
niškë	niški	Afpnsan-n
njagä	njagä	Ps3---sm--a
njeha	njagä	Ps3---sm--a
njeha	un	Pp3msg--n-n
njemu	un	Pp3msl--n-n
nji	nji	Ps3---sf--a
njima	un	Pp3-dd--n-n
njima	un	Pp3-di--n-n
njimi	un	Pp3-pi--n-n
nju	njü	Ps3---d---a
njà	njagä	Ps3---sm--a
njïmi	un	Pp3-pi--n-n
no	dan	Tifsa
no	dan	Tinsa-n
noga	dan	Timsa-y
noga	dan	Timsg
noga	dän	Mcmsal---y
nárit	naredit	Vmp----p------e
náshe	näš	Ps1mpap---a
näšnji	näšnji	Afpmsa--n
nì	dan	Tifsd
nì	dan	Tifsl
ní	bet	Vcip3s--y-----p
nò	dan	Tifsi
nò	dän	Mcfsil
nöbbe	nëbë	Ncnsa--n
nöbbe	nëbë	Ncnsl
objoče	objökat	Vmip3s--n-----e
oblejan	oblajän	Afpmsnn
od	od	Spsg
odparle	udprit	Vmps-pna------e
odposgiúomo	utpušćüwat	Vmip1p--n-----p
odpuštjúvamo	utpušćüwat	Vmip1p--n-----p
oh	ö	I
omužila	umužet	Vmps-sfa------e
ona_dua	un	Pp3mdn--n-n
onadva	un	Pp3mdn--n-n
onè	un	Pp3fpn--n-n
oro	ora	Ncfsa
ospodine	guspuden	Ncmpa
ospodinon	guspuden	Ncmsi
ostane	ostät	Vcip3s--n-----e
ot	od	Spsn
ozhmi	öku	Ncnpi
oči	öku	Ncnpn
očú	öku	Ncnpg
pa	pa	Q
par	par	Ncmsa--n
par	par	Spsl
paragionu	paraćät	Vmp--snp------e
parbližal	parblïžat	Vmps-sma------e
parsilila	parsïlit	Vmps-dma------e
paruva	pärvi	Mofsnl
parve	pärvi	Mofsgl
parve	pärvi	Momsnl
parvi	pärvi	Momsnl
paršle	prït	Vmps-pfa------e
pashló	prït	Vmps-sna------e
per	par	Spsd
persunah	parsuna	Ncfpl
pidè	pujtet	Vmsp3s--------e
pisma	pïsmu	Ncnpa
pismeh	pïsmu	Ncnpl
po	po	Spsl
poite	pujtet	Vmmp2p--------en
porazhanin	poračan	Afpmpd
potečajov	potečaj	Ncmpg
povi	puvet	Vmia3s--n-----e
pozali	počnet	Vmps-pma------e
poznahata	poznät	Vmii3d--------e
poznala	poznät	Vmps-dma------e
poznala	poznät	Vmps-dma------p
pošlišata	pušlüšat	Vmip2p--n-----pn
prabet	pribet	Vmn-----------e
prajale	prihajat	Vmps-pfa------p
pravijahata	pravit	Vmii3d--------p
pravijaho	pravit	Vmii3p--------p
prašávahata	pravit	Vmii3d--------p
preponinan	preponinat	Vmip1s--n-----e
prid	prid	Spsi
pride	prït	Vmip3s--n-----e
pride	prït	Vmsp3s--------e
prit_nikoj	pridniköj	Ccc
prosite	pruset	Vmmp2p--------py
prwa	pärvi	Mofsnl
pródali	prodät	Vmps-pma------e
punczaha	punčak	Afpfsn
pärvih	pärvi	Mofpgl
pírsten	pärstën	Ncmsa--n
rabio	rabja	Ncfsi
raccomandan	rakomandät	Vmip1s--n-----e
rekal	rićet	Vmps-sma------p
rekla	rićet	Vmps-dma------p
reči	rič	Ncfpn
romoni	romon	Ncmpn
romonjaše	rumunet	Vmii3s--------p
rozajanskin	rozajanski	Afpnsl
ráme	rama	Ncfpa
rékal	rićet	Vmps-sma------p
s	s	X
s	s	Y
s	z	Spsi
sa_ito_kir	zajtökir	Csc
sabò	se	Px---i--npn
sadgne	zadnji	Afpfpn
saliuajo	zalïwat	Vmip3p--n-----p
sam	sam	Afpmsnn
sam	sam	Pg-msn----nn
sam_ha	sam	Pg-msa----a-y
samaha	sam	Pg-msa----a-y
samega	sam	Pg-msa----a-y
sami	sam	Afpmsny
sami	sam	Pg-mpn----a
samo	sam	Afpfsi
san	sam	Pg-msn----an
saplaçhiní	zaplaćën	Afpmpgn
sardca	särcë	Ncnsg
sarzam	särcë	Pg-nsi----a
sauvocha	zawojoka	Csc
sauvojo	zawojo	Spcg
sdelale	zdëlat	Vmps-pfa------e
sdelalo	zdëlat	Vmps-sna------e
sdilano	zdëlat	Vmp--snp------e
sdìllana	zdëlat	Vmp--sfp------e
sdělalo	zdëlat	Vmps-sna------e
se	bet	Vcip1s--n-----p
se	se	Px------y
sebe	sabe	Px---a--npn
seh	isi	Pd-fpg----a
sehond	sagont	Mo---l
sehont	sagont	Mo---l
sema	isi	Pd-mdi----n
semi	isi	Pd-fpi----a
serviaj	sarvijät	Vmsp1s--------e
servian	sarvijät	Vmip1s--------e
servian	sarvijät	Vmip1s--------p
ses_med	zizmid	Spcg
shanami	žanä	Ncfpi
shihnani	žignan	Afpmsay-n
shtiri	štirji	Mcfpnl
shurigne	zurinji	Afpfsg
shvote	žwöt	Ncmsl
si	bet	Vaip1s--n-----p
si	bet	Vaip2s--n-----p
si	bet	Vcip1s--n-----p
si	bet	Vcip2s--n-----p
si	isi	Pd-mpn----a
si	sabe	Px---d--ypn
si	si	Px------y
sin	sïn	Ncmsn
sina	sïn	Ncmsa--y
sinu	sïn	Ncmda
sinuvi	sïn	Ncmpn
slabo	släb	Afpfsan
sladkega	sladak	Afpmsa--y
slizejo	slić	Vmip3p--n-----e
smarti	smärt	Ncfsg
smela	smët	Vops-sfa------p
smilne	smïlan	Afpnpa
snaj	znät	Vmsp1s--------p
snate	morët	Vmip2p--n-----pn
snídal	snëst	Vmps-sma------e
so	bet	Vaip3p--n-----p
so	bet	Vcip3p--n-----p
sowa	bet	Vaip1d--n-----p
spasima	spasim	Ncms
spat	spät	Vmu-----------p
sta	bet	Vaip3d--n-----p
sta	bet	Vcip2d--n-----p
staraisi	stär	Afcmsn
starkrat_duísti_anu_dévatnist	štirkratdwistinudëvatnist	Mc-p-l
ste	bet	Vaip2p--n-----py
strasne	štrašan	Afpmpa
stè	bet	Vcip2p--n-----py
stö	bet	Vcip2p--n-----py
succedenala	sucëdinat	Vmps-sfa------e
sughimi	süh	Afpnpi
sulzí	sulza	Ncfpg
sve	swöj	Afpmpa
sve	swöj	Px-mpa---sa
svesan	zvezat	Vmp--smp------e
sveti	svet	Afpnsnn
svetih	svet	Afpmpg
sveto	svet	Afpfsi
swetaha	svet	Afpmsg
sweto	svet	Afpfsa
sò	bet	Vcip3p--n-----p
sömö	bet	Vaip1p--n-----p
ta	tah	Spcd
ta	te	Tffsn
ta-mi	tamid	Spci
ta_h	tah	Spcd
ta_mej	tami	Spci
ta_pod	tapod	Spc
tabe	tï	Pp2-sd--n-n
taga	te	Tfmsg
tagha	iti	Pd-nsg----a
takaha	itak	Pg-nsg----n
take	taki	Pd-nsa----a-n
taleta	tale	Ncnsa--y
taléta	tale	Ncnsa--y
tana	tana	Spca
taper	tapar	Spcd
tapod	tapod	Spci
taprit	taprid	Spcg
tardim	tärd	Afpnsi
tarnouo	tärnuw	Aopfsi
tarpite	tpët	Vmip2p--n-----py
tau	tuw	Spca
tau	tuw	Spcl
taêbô	tï	Pp2-si--n-n
te	iti	Pd-fpa----a
te	iti	Pd-fpg----a
te	iti	Pd-fpn----a
te	te	Tffpa
te	te	Tffpg
te	te	Tffpn
te	te	Tffsg
te	te	Tfmpa
te	te	Tfmsa-n
te	te	Tfmsn
te	te	Tfnpa
te	tï	Pp2-sa--b-n
te	tï	Pp2-sa--y-n
te	tï	Pp2-sg--y-n
tega	iti	Pd-nsg----n
teh	te	Tfmpg
teita	tët	Vcmp2p--------pn
tel	tët	Vops-sma------p
temi	te	Tffpi
teraze	teraca	Ncfsl
tese	tët	Voii3s--------p
tesni	tesni	Afpfsl
tesniey	tesni	Afpfsl
teu	tët	Vops-sma------p
tey	te	Tffsl
ti	iti	Pd-fsl----a
ti	iti	Pd-mpn----n
ti	te	Tffsl
ti	te	Tfmpn
ti	te	Tfnsl
ti	tï	Pp2-sd--y-n
ti	tï	Pp2-sn--n-n
ti	tï	Pp2-sn--y-n
tiemo	tët	Vaip1p--n-----p
tih	iti	Pd-npl----a
tih	te	Tffpg
tih	te	Tfmpg
tih	te	Tfnpl
tim	te	Tfmpd
timpa	temp	Ncmsg
timpu	temp	Ncmsl
tin	te	Tfmpd
tin	te	Tfmsl
tiviga	twöj	Ps2msas---a-y
to	iti	Pd-nsn----n
to	te	Tffsa
to	te	Tffsi
to	te	Tfnsa-n
to	to	Pp3nsn--y-n
tobe	tï	Pp2-sd--n-n
toga	te	Tfnsa-y
tomu	te	Tfmsd
toshni	tožan	Afpmpn
tosno	tožan	Afpnsnn
tou	tuw	Spc
tožna	tožan	Afpmdn
tradis	tradet	Vmip2s--n-----p
treh	trïji	Mc-pgl
treh	trïji	Mc-pll
tretgna	trëtnji	Mofsnl
tretgni	trëtnji	Momsal---n
tretni	trëtnji	Momsal---n
tretnji	trëtnji	Momsnl
tri	trïji	Mcfpal
tri	trïji	Mcfpnl
tri	trïji	Mcmpnl
trij	trïji	Mcmpnl
trivin	twöj	Ps2nsis---a
tromentih	torment	Ncmpl
trì	trïji	Mcfpnl
tulstaga	tulst	Afpnsa--y
tulste	tulst	Afpnsay-n
tuoi	twöj	Ps2msns---a
tuv	tuw	Spcl
tuvoi	twöj	Ps2msns---a
tuói	twöj	Ps2msns---a
tuö	twöj	Ps2nsns---n
tvíga	twöj	Ps2msas---a-y
tàpot	tapod	Spc
tácui	takoj	Ccs
tè	iti	Pd-msa----a-n
tè	te	Tffpa
tè	te	Tffsg
tè	te	Tfmpa
tè	tï	Pp2-sa--y-n
téshe	tët	Voii3s--------p
tì	te	Tffsl
tí	tï	Pp2-sn--n-n
tò	iti	Pd-nsa----a-n
tö	te	Tfnsa-n
túlstaga	tulst	Afpnsa--y
uam	vï	Pp2-pd--y-n
uami	vï	Pp2-pi--n-n
uas	vï	Pp2-pg--n-n
uas	wäš	Ps2msnp---a
uase	wäš	Ps2npap---a
uase	wäš	Ps2nsnp---a
ublicílu	ubličïlu	Ncnsa--n
umorili	umuret	Vmps-pma------e
uon	un	Pp3msn--n-n
usacha	wsak	Pg-fsn----n
usachin	wsak	Pg-msl----a
usaki	wsak	Pg-fsl----n
usaki	wsak	Pg-msa----ayn
usako	wsak	Pg-fsa----a
usami	wzet	Vmmp2s--------e
use	väs	Pg-fpa----a
use	väs	Pg-fpn----a
use	väs	Pg-mpn----a
use	väs	Pg-nsa----n-n
use	väs	Pg-nsn----n
useh	väs	Pg-fpl----a
useh	väs	Pg-npl----a
usemi	väs	Pg-mpi----a
usi	väs	Pg-mpn----n
usih	väs	Pg-mpg----n
usiha	väs	Pg-nsg----a
usim	väs	Pg-nsi----a
uso	väs	Pg-fsa----a
uso	väs	Pg-fsi----a
usse	väs	Pg-nsn----a
ussi	väs	Pg-mpn----a
ussáke_dögne	wsakidinji	Aopmsa--n
ussé	väs	Pg-fpa----a
ussé	väs	Pg-nsn----a
ustala	wstät	Vmps-dma------e
uun	un	Pp3msn--n-n
uvami	vï	Pp2-pi--n-n
uvan	vï	Pp2-pd--n-n
uvan	vï	Pp2-pd--y-n
uvas	vï	Pp2-pa--n-n
uvas	vï	Pp2-pa--y-n
uvas	vï	Pp2-pg--n-n
uvasha	wäš	Ps2fsnp---a
uvashaha	wäš	Ps2msgp---a
uvashe	wäš	Ps2npap---a
uvashe	wäš	Ps2nsnp---a
uvashin	wäš	Ps2mpdp---a
uvasho	wäš	Ps2fsip---a
uvaſsi	wäš	Ps2fslp---a
uvmarjo	wmrit	Vmip3p--n-----e
uvsachi	wsak	Pg-fsl----a
uvsachidigni	wsakidinji	Aopmsa--n
uvsachin	wsak	Pg-nsl----a
uvsacho	wsak	Pg-fsi----a
uvsdahujamo	wzdahüwat	Vmip1p--n-----p
uvse	väs	Pg-mpa----a
uvsen	väs	Pg-msl----a
uvshivaj	wžïwat	Vmsp1s--------p
uvsà	väs	Pg-fsn----a
uvsè	väs	Pg-fpn----a
uvsè	väs	Pg-nsa----n-n
uçhí	oćä	Ncmsd
v	w	Spsa
vagh	već	Rgc
vam	vï	Pp2-pd--y-n
vami	vï	Pp2-pi--n-n
vassaléimo	vasalët	Vmmp1p--------p
vaš	wäš	Ps2msnp---a
vec	već	Rgc
vedle	vëdët	Vmps-pma------p
veliki	vilek	Afpmpn
ver	vër	Afp
verjen	vërwat	Vmip1s--n-----p
veruat	vërwat	Vmn-----------p
ves	väs	Pg-msa----a-n
vi	vï	Pp2-dn--y-n
vi	vï	Pp2-pn--n-n
vi	vï	Pp2-pn--y-n
videle	vïdët	Vmps-pfa------p
videt	vïdët	Vmn-----------p
vidi	vïdët	Vmmp2s--------p
vidim	vïdët	Vmip1s--n-----p
vijo	vëdët	Vmip3p--n-----p
vikupit	viküpit	Vmn-----------e
vilisou	vilëst	Vmps-sma------e
vinzha	vinči	Afcfsn
virtudijo	virtud	Ncfsi
visachimù	visök	Afpmsd
viš	vëdët	Vmip2s--n-----p
volontát	volontad	Ncfsn
vse	väs	Pg-fpa----a
vse	väs	Pg-fsg----a
vse	väs	Pg-nsa----a-n
vseh	väs	Pg-mpg----a
vsih	väs	Pg-mpg----a
vuaschin	wsak	Pg-nsl----a
vusè	väs	Pg-nsa----a-n
vvesejo	wezat	Vmip3p--n-----e
vénci	vilek	Afcmsn
w	w	Spsa
wasza	wäš	Ps2fsnp---a
waszaha	wäš	Ps2msgp---a
wasze	wäš	Ps2nsnp---a
wodo	wöda	Ncfsi
wsak	wsak	Pg-msn----an
wsakiedennie	wsakidinji	Aopmsa--n
wsie	väs	Pg-nsa----n-n
wso	väs	Pg-fsa----a
wybronite	vibranit	Vmmp2p--------ey
za	za	Sps
zanè	žanä	Ncfda
zbranih	zbrän	Afpmpg
zdjilana	zdëlat	Vmp--sfp------e
zimièu	zëmja	Ncfsl
zis	ziz	Spsi
časa	čäs	Ncmsg
šesterdov	šastardu	Mc-p-l
šli	tet	Vmps-pma------p
šlè	tet	Vmps-pfa------p
šolbaške	solbaški	Afpfda
šćarì	hćï	Ncfpg
živi	žïvit	Vmip3s--n-----p
žuotá	žwöt	Ncmsg
’n	un	Pp3msn--y-n
